0000000001011000/0000000000000000
1111111111101000/0000000000000000
1111111110110000/0000000000000000
0000000001100000/0000000000000000
1111111110111000/0000000000000000
1111111111101000/0000000000000000
0000000001010000/0000000000000000
1111111110010000/0000000000000000
0000000000100000/0000000000000000
0000000000100000/0000000000000000
1111111110010000/0000000000000000
0000000001010000/0000000000000000
1111111111101000/0000000000000000
1111111110110000/0000000000000000
0000000001100000/0000000000000000
1111111110111000/0000000000000000
1111111111011000/0000000000000000
0000000001000010/1111111111100011
1111111111011110/0000000000100010
0000000000000000/0000000000000000
0000000000000000/1111111111001000
0000000000011100/0000000001000010
1111111111101001/1111111111101001
1111111111110001/1111111111111001
0000000001000000/0000000000000000
1111111111000101/0000000000011000
0000000000001011/1111111111110100
0000000000001100/1111111111100010
0000000000000000/0000000001001000
1111111111101110/1111111111010011
0000000000000000/0000000000000000
0000000000110011/0000000000010101
