0000000010011000/0000000000000000
1111111011110000/0000000000000000
0000000001010000/0000000000000000
0000000000010000/0000000000000000
1111111110110000/0000000000000000
0000000011110000/0000000000000000
1111111101000000/0000000000000000
1111111101100000/0000000000000000
0000000011010000/0000000000000000
1111111110100000/0000000000000000
0000000001101000/0000000000000000
0000000000110000/0000000000000000
1111111011001000/0000000000000000
0000000010011000/0000000000000000
0000000001010000/0000000000000000
1111111101111000/0000000000000000
1111111111101000/0000000000000000
0000000010111111/1111111110101110
0000000001111011/1111111110000001
1111111110100110/0000000011011101
0000000000000000/0000000000110000
0000000000000110/0000000000001110
0000000000101110/0000000000101110
1111111101001111/1111111110110101
0000000000100000/0000000000000000
0000000000101100/1111111111101110
1111111110011110/0000000001011111
0000000001000100/1111111101011101
0000000000000000/1111111110101000
0000000000011011/0000000001000010
1111111111110100/1111111111110100
0000000011100100/0000000001011101
